4800,20000,1,1,3,2,0,0,
5,0,0,15,30,100,2,6,
6,0,0,15,30,100,2,6,
7,0,600,150,300,100,5,8,
8,0,900,200,450,100,5,8,
10,0,1200,600,800,100,3,5,
11,0,1500,1100,1700,100,0,0,
12,0,1800,650,1200,100,1,2,
24,1,2100,1,1,100,1,1,
23,0,13500,13500,13500,100,9,9,
0,0,0,0,0,0,0,9,
0,0,0,0,0,0,0,9,
0,0,0,0,0,0,0,9,
0,0,0,0,0,0,0,9,
0,0,0,0,0,0,0,9,
0,0,0,0,0,0,0,9,
0,0,0,0,0,0,0,9,
0,0,0,0,0,0,0,9,
0,0,0,0,0,0,0,9,
0,0,0,0,0,0,0,9,
0,0,0,0,0,0,0,9,
