4000,18000,15,90,0,6,0,0,
3,0,150,75,100,100,0,7,
4,0,300,100,150,100,7,9,
15,0,600,150,300,100,6,9,
9,0,900,150,300,100,0,5,
8,0,1500,450,900,100,5,8,
10,0,3000,450,900,100,4,6,
7,0,1200,450,900,100,6,8,
5,0,1800,450,900,100,0,5,
6,0,1800,450,900,100,0,5,
8,0,2000,450,900,100,5,8,
8,4,0,1,1,50,5,8,
23,0,13500,13500,13500,100,9,9,
0,0,0,0,0,0,0,9,
0,0,0,0,0,0,0,9,
0,0,0,0,0,0,0,9,
0,0,0,0,0,0,0,9,
0,0,0,0,0,0,0,9,
0,0,0,0,0,0,0,9,
0,0,0,0,0,0,0,9,
0,0,0,0,0,0,0,9,
