3600,1000,1,1,0,3,0,0,
11,1,0,60,80,100,0,9,
11,0,300,90,150,100,0,9,
11,8,0,15,15,50,0,9,
23,0,13500,13500,13500,100,9,9,
0,0,0,0,0,0,0,9,
0,0,0,0,0,0,0,9,
0,0,0,0,0,0,0,9,
0,0,0,0,0,0,0,9,
0,0,0,0,0,0,0,9,
0,0,0,0,0,0,0,9,
0,0,0,0,0,0,0,9,
0,0,0,0,0,0,0,9,
0,0,0,0,0,0,0,9,
0,0,0,0,0,0,0,9,
0,0,0,0,0,0,0,9,
0,0,0,0,0,0,0,9,
0,0,0,0,0,0,0,9,
0,0,0,0,0,0,0,9,
0,0,0,0,0,0,0,9,
0,0,0,0,0,0,0,9,
