4000,20000,1,1,0,8,0,0,
2,0,0,150,450,100,1,4,
4,0,0,150,450,100,7,9,
4,0,0,15,150,95,7,8,
17,0,450,150,450,100,1,8,
8,1,0,15,100,99,1,8,
8,1,0,15,100,97,1,8,
8,1,0,15,100,95,1,8,
8,1,0,15,100,93,1,8,
15,0,0,15,150,92,1,8,
17,0,0,15,150,92,1,8,
24,1,0,1,1,92,0,0,
23,0,13500,13500,13500,100,9,9,
0,0,0,0,0,0,0,9,
0,0,0,0,0,0,0,9,
0,0,0,0,0,0,0,9,
0,0,0,0,0,0,0,9,
0,0,0,0,0,0,0,9,
0,0,0,0,0,0,0,9,
0,0,0,0,0,0,0,9,
0,0,0,0,0,0,0,9,
