3600,9000,2,15,0,10,0,0,
4,0,0,15,300,100,0,9,
4,0,0,15,300,100,0,9,
4,0,150,15,150,100,0,9,
8,1,1500,800,1200,100,0,5,
9,0,900,15,150,100,2,8,
8,2,2000,1,1,100,0,5,
9,10,0,15,30,60,2,8,
23,0,13500,13500,13500,100,9,9,
0,0,0,0,0,0,0,9,
0,0,0,0,0,0,0,9,
0,0,0,0,0,0,0,9,
0,0,0,0,0,0,0,9,
0,0,0,0,0,0,0,9,
0,0,0,0,0,0,0,9,
0,0,0,0,0,0,0,9,
0,0,0,0,0,0,0,9,
0,0,0,0,0,0,0,9,
0,0,0,0,0,0,0,9,
0,0,0,0,0,0,0,9,
0,0,0,0,0,0,0,9,
