5000,3500,2,150,1,6,0,0,
2,0,0,160,280,100,0,6,
3,0,120,300,800,100,0,6,
4,0,600,150,600,100,6,9,
4,6,0,30,60,90,6,9,
5,1,0,15,30,80,0,0,
5,1,0,15,30,40,1,1,
23,0,13500,13500,13500,100,9,9,
0,0,0,0,0,0,0,9,
0,0,0,0,0,0,0,9,
0,0,0,0,0,0,0,9,
0,0,0,0,0,0,0,9,
0,0,0,0,0,0,0,9,
0,0,0,0,0,0,0,9,
0,0,0,0,0,0,0,9,
0,0,0,0,0,0,0,9,
0,0,0,0,0,0,0,9,
0,0,0,0,0,0,0,9,
0,0,0,0,0,0,0,9,
0,0,0,0,0,0,0,9,
0,0,0,0,0,0,0,9,
