3600,15000,1,1,1,20,0,0,
15,1,0,1,1,100,1,9,
15,0,150,80,120,100,1,9,
15,0,450,60,120,100,1,9,
15,0,0,45,120,70,1,9,
15,0,0,45,120,70,1,9,
15,0,0,1,30,70,1,9,
15,0,0,60,150,90,1,9,
10,1,0,1,1,90,0,0,
23,0,13500,13500,13500,100,9,9,
0,0,0,0,0,0,0,9,
0,0,0,0,0,0,0,9,
0,0,0,0,0,0,0,9,
0,0,0,0,0,0,0,9,
0,0,0,0,0,0,0,9,
0,0,0,0,0,0,0,9,
0,0,0,0,0,0,0,9,
0,0,0,0,0,0,0,9,
0,0,0,0,0,0,0,9,
0,0,0,0,0,0,0,9,
0,0,0,0,0,0,0,9,
