4800,7000,2,150,2,6,0,0,
4,0,0,15,150,100,1,7,
2,0,0,150,300,100,1,7,
4,0,0,150,300,100,6,9,
4,12,300,10,30,85,6,9,
8,1,0,1,1,85,0,0,
8,1,0,900,900,60,5,5,
23,0,13500,13500,13500,100,9,9,
0,0,0,0,0,0,0,9,
0,0,0,0,0,0,0,9,
0,0,0,0,0,0,0,9,
0,0,0,0,0,0,0,9,
0,0,0,0,0,0,0,9,
0,0,0,0,0,0,0,9,
0,0,0,0,0,0,0,9,
0,0,0,0,0,0,0,9,
0,0,0,0,0,0,0,9,
0,0,0,0,0,0,0,9,
0,0,0,0,0,0,0,9,
0,0,0,0,0,0,0,9,
0,0,0,0,0,0,0,9,
